#####  ###
##### ####
###B# ####
###   ####
#####A####